Rk,Player,Pos,Age,Tm,G,GS,MP,FG,FGA,FG%,3P,3PA,3P%,2P,2PA,2P%,eFG%,FT,FTA,FT%,ORB,DRB,TRB,AST,STL,BLK,TOV,PF,PTS▼
1,Russell Westbrook\westbru01,PG,28,OKC,81,81,2802,824,1941,.425,200,583,.343,624,1358,.459,.476,710,840,.845,137,727,864,840,132,31,438,190,2558
2,James Harden\hardeja01,PG,27,HOU,81,81,2947,674,1533,.440,262,756,.347,412,777,.530,.525,746,881,.847,95,564,659,907,121,38,464,215,2356
3,Isaiah Thomas\thomais02,PG,27,BOS,76,76,2569,682,1473,.463,245,646,.379,437,827,.528,.546,590,649,.909,43,162,205,448,70,13,210,167,2199
4,Anthony Davis\davisan02,C,23,NOP,75,75,2708,770,1526,.505,40,134,.299,730,1392,.524,.518,519,647,.802,172,712,884,157,94,167,181,168,2099
5,Karl-Anthony Towns\townska01,C,21,MIN,82,82,3030,802,1480,.542,101,275,.367,701,1205,.582,.576,356,428,.832,296,711,1007,220,56,103,212,241,2061
6,Damian Lillard\lillada01,PG,26,POR,75,75,2694,661,1488,.444,214,579,.370,447,909,.492,.516,488,545,.895,46,322,368,440,68,20,197,152,2024
7,DeMar DeRozan\derozde01,SG,27,TOR,74,74,2620,721,1545,.467,33,124,.266,688,1421,.484,.477,545,647,.842,70,316,386,290,78,13,180,134,2020
8,Stephen Curry\curryst01,PG,28,GSW,79,79,2638,675,1443,.468,324,789,.411,351,654,.537,.580,325,362,.898,61,292,353,524,142,17,239,183,1999
9,LeBron James\jamesle01,SF,32,CLE,74,74,2794,736,1344,.548,124,342,.363,612,1002,.611,.594,358,531,.674,97,542,639,646,92,44,303,134,1954
10,DeMarcus Cousins\couside01,C,26,TOT,72,72,2465,647,1432,.452,131,363,.361,516,1069,.483,.498,517,670,.772,152,642,794,332,100,93,269,278,1942
11,Andrew Wiggins\wiggian01,SF,21,MIN,82,82,3048,709,1570,.452,103,289,.356,606,1281,.473,.484,412,542,.760,102,226,328,189,82,30,187,183,1933
12,Kawhi Leonard\leonaka01,SF,25,SAS,74,74,2474,636,1312,.485,147,387,.380,489,925,.529,.541,469,533,.880,80,350,430,260,133,55,154,122,1888
13,CJ McCollum\mccolcj01,SG,25,POR,80,80,2796,692,1441,.480,185,439,.421,507,1002,.506,.544,268,294,.912,60,229,289,285,72,42,172,202,1837
14,Giannis Antetokounmpo\antetgi01,SF,22,MIL,80,80,2845,656,1259,.521,49,180,.272,607,1079,.563,.541,471,612,.770,142,558,700,434,131,151,234,246,1832
15,Kemba Walker\walkeke02,PG,26,CHO,79,79,2739,643,1449,.444,240,602,.399,403,847,.476,.527,304,359,.847,45,263,308,434,85,22,168,119,1830
16,Jimmy Butler\butleji01,SF,27,CHI,76,75,2809,570,1252,.455,91,248,.367,479,1004,.477,.492,585,676,.865,129,341,470,417,143,32,159,112,1816
17,Kyrie Irving\irvinky01,PG,24,CLE,72,72,2525,671,1420,.473,177,441,.401,494,979,.505,.535,297,328,.905,52,178,230,418,83,24,180,157,1816
18,John Wall\walljo01,PG,26,WAS,78,78,2836,647,1435,.451,89,272,.327,558,1163,.480,.482,422,527,.801,59,267,326,831,157,49,322,151,1805
19,Bradley Beal\bealbr01,SG,23,WAS,77,77,2684,637,1322,.482,223,552,.404,414,770,.538,.566,282,342,.825,53,187,240,267,83,21,156,169,1779
20,Paul George\georgpa01,SF,26,IND,75,75,2689,622,1348,.461,195,496,.393,427,852,.501,.534,336,374,.898,58,434,492,251,119,27,220,206,1775
21,Klay Thompson\thompkl01,SG,26,GSW,78,78,2649,644,1376,.468,268,647,.414,376,729,.516,.565,186,218,.853,49,236,285,160,66,40,128,139,1742
22,Devin Booker\bookede01,SG,20,PHO,78,78,2730,606,1431,.423,147,405,.363,459,1026,.447,.475,367,441,.832,46,203,249,268,72,21,241,242,1726
23,Carmelo Anthony\anthoca01,SF,32,NYK,74,74,2538,602,1389,.433,151,421,.359,451,968,.466,.488,304,365,.833,62,376,438,213,60,34,153,198,1659
24,Gordon Hayward\haywago01,SF,26,UTA,73,73,2516,545,1156,.471,149,374,.398,396,782,.506,.536,362,429,.844,49,345,394,252,73,20,140,117,1601
25,Kevin Durant\duranke01,PF,28,GSW,62,62,2070,551,1026,.537,117,312,.375,434,714,.608,.594,336,384,.875,39,474,513,300,66,99,138,117,1555
26,Brook Lopez\lopezbr01,C,28,BRK,75,75,2222,555,1172,.474,134,387,.346,421,785,.536,.531,295,364,.810,121,282,403,176,38,124,184,192,1539
27,Harrison Barnes\barneha02,PF,24,DAL,79,79,2803,599,1280,.468,78,222,.351,521,1058,.492,.498,242,281,.861,93,301,394,116,65,15,102,128,1518
28,Goran Dragić\dragigo01,PG,30,MIA,73,73,2459,534,1124,.475,117,289,.405,417,835,.499,.527,298,377,.790,62,217,279,423,89,13,212,199,1483
29,Marc Gasol\gasolma01,C,32,MEM,74,74,2531,532,1160,.459,104,268,.388,428,892,.480,.503,278,332,.837,60,404,464,338,67,99,166,171,1446
30,Lou Williams\willilo02,SG,30,TOT,81,1,1994,428,998,.429,163,446,.365,265,552,.480,.511,402,457,.880,26,176,202,239,80,20,160,92,1421
31,Mike Conley\conlemi01,PG,29,MEM,69,68,2292,464,1009,.460,171,419,.408,293,590,.497,.545,316,368,.859,31,210,241,433,92,19,156,126,1415
32,Dennis Schröder\schrode01,PG,23,ATL,79,78,2485,548,1214,.451,100,294,.340,448,920,.487,.493,218,255,.855,42,206,248,499,74,16,258,149,1414
33,Eric Bledsoe\bledser01,PG,27,PHO,66,66,2176,449,1034,.434,104,310,.335,345,724,.477,.485,388,458,.847,52,268,320,418,91,31,224,164,1390
34,Kyle Lowry\lowryky01,PG,30,TOR,60,60,2244,426,918,.464,193,468,.412,233,450,.518,.569,299,365,.819,48,238,286,417,88,19,173,170,1344
35,Tobias Harris\harrito02,PF,24,DET,82,48,2567,511,1063,.481,109,314,.347,402,749,.537,.532,190,226,.841,63,353,416,142,60,39,96,133,1321
36,Blake Griffin\griffbl01,PF,27,LAC,61,61,2076,479,971,.493,38,113,.336,441,858,.514,.513,320,421,.760,112,385,497,300,57,22,142,157,1316
37,Hassan Whiteside\whiteha01,C,27,MIA,77,77,2513,542,973,.557,0,0,,542,973,.557,.557,225,358,.628,293,795,1088,57,57,161,154,226,1309
38,Jeff Teague\teaguje01,PG,28,IND,82,82,2657,402,909,.442,90,252,.357,312,657,.475,.492,360,415,.867,33,297,330,639,100,32,216,165,1254
39,Paul Millsap\millspa01,PF,31,ATL,69,67,2343,430,972,.442,75,241,.311,355,731,.486,.481,311,405,.768,111,422,533,252,90,62,158,186,1246
40,LaMarcus Aldridge\aldrila01,PF,31,SAS,72,72,2335,500,1049,.477,23,56,.411,477,993,.480,.488,220,271,.812,172,351,523,139,46,88,98,158,1243
41,Nikola Jokić\jokicni01,C,21,DEN,73,59,2038,494,854,.578,45,139,.324,449,715,.628,.605,188,228,.825,212,506,718,359,61,55,171,214,1221
42,Eric Gordon\gordoer01,SG,28,HOU,75,15,2323,412,1016,.406,246,661,.372,166,355,.468,.527,147,175,.840,29,172,201,188,48,41,121,150,1217
43,Jordan Clarkson\clarkjo01,SG,24,LAL,82,19,2397,477,1071,.445,117,356,.329,360,715,.503,.500,134,168,.798,49,197,246,213,88,8,164,150,1205
44,Kristaps Porziņģis\porzikr01,PF,21,NYK,66,65,2164,443,985,.450,112,314,.357,331,671,.493,.507,198,252,.786,111,364,475,97,47,129,118,244,1196
45,Serge Ibaka\ibakase01,PF,27,TOT,79,79,2422,471,982,.480,124,317,.391,347,665,.522,.543,107,125,.856,129,409,538,75,41,124,105,215,1173
46,J.J. Redick\redicjj01,SG,32,LAC,78,78,2198,396,890,.445,201,468,.429,195,422,.462,.558,180,202,.891,11,160,171,110,54,13,98,125,1173
47,Myles Turner\turnemy01,C,20,IND,81,81,2541,444,869,.511,40,115,.348,404,754,.536,.534,245,303,.809,139,450,589,106,74,172,105,262,1173
48,Evan Fournier\fournev01,SG,24,ORL,68,66,2234,408,930,.439,128,360,.356,280,570,.491,.508,223,277,.805,44,165,209,202,66,4,141,180,1167
49,Nicolas Batum\batumni01,SG,28,CHO,77,77,2617,393,975,.403,135,405,.333,258,570,.453,.472,243,284,.856,46,435,481,456,86,29,194,109,1164
50,Derrick Rose\rosede01,PG,28,NYK,64,64,2082,460,977,.471,13,60,.217,447,917,.487,.477,221,253,.874,66,180,246,283,44,17,147,84,1154
51,Danilo Gallinari\gallida01,SF,28,DEN,63,63,2134,335,750,.447,126,324,.389,209,426,.491,.531,349,387,.902,39,286,325,135,40,15,82,93,1145
52,Tim Hardaway\hardati02,SG,24,ATL,79,30,2154,415,912,.455,149,417,.357,266,495,.537,.537,164,214,.766,35,189,224,182,55,15,106,103,1143
53,Kevin Love\loveke01,PF,28,CLE,60,60,1885,370,867,.427,145,389,.373,225,478,.471,.510,257,295,.871,148,518,666,116,53,21,122,125,1142
54,Rudy Gobert\goberru01,C,24,UTA,81,81,2744,413,625,.661,0,1,.000,413,624,.662,.661,311,476,.653,314,721,1035,97,49,214,147,246,1137
55,Wilson Chandler\chandwi01,SF,29,DEN,71,33,2197,433,939,.461,110,326,.337,323,613,.527,.520,141,194,.727,103,357,460,141,51,30,114,172,1117
56,Bojan Bogdanović\bogdabo02,SF,27,TOT,81,54,2083,376,845,.445,144,392,.367,232,453,.512,.530,217,243,.893,37,240,277,111,34,7,131,146,1113
57,Andre Drummond\drumman01,C,23,DET,81,81,2409,483,911,.530,2,7,.286,481,904,.532,.531,137,355,.386,345,770,1115,90,124,89,152,237,1105
58,Marcus Morris\morrima03,SF,27,DET,79,79,2565,421,1007,.418,118,357,.331,303,650,.466,.477,145,185,.784,77,289,366,160,52,25,87,168,1105
59,Chris Paul\paulch01,PG,31,LAC,61,61,1921,374,785,.476,124,302,.411,250,483,.518,.555,232,260,.892,40,264,304,563,119,8,147,146,1104
60,Nikola Vučević\vucevni01,C,26,ORL,75,55,2163,483,1031,.468,23,75,.307,460,956,.481,.480,107,160,.669,176,603,779,208,76,74,117,180,1096
61,Dwyane Wade\wadedw01,SG,35,CHI,60,59,1792,414,955,.434,45,145,.310,369,810,.456,.457,223,281,.794,63,207,270,228,86,41,138,112,1096
62,Otto Porter\porteot01,SF,23,WAS,80,80,2605,414,803,.516,148,341,.434,266,462,.576,.608,99,119,.832,118,396,514,121,116,42,44,193,1075
63,Ersan İlyasova\ilyaser01,PF,29,TOT,82,52,2142,384,890,.431,142,402,.353,242,488,.496,.511,161,207,.778,115,366,481,141,58,23,116,211,1071
64,Victor Oladipo\oladivi01,SG,24,OKC,67,67,2222,412,932,.442,127,352,.361,285,580,.491,.510,116,154,.753,39,252,291,176,78,21,119,155,1067
65,Markieff Morris\morrima02,PF,27,WAS,76,76,2374,406,889,.457,71,196,.362,335,693,.483,.497,180,215,.837,107,386,493,126,82,42,129,254,1063
66,Kentavious Caldwell-Pope\caldwke01,SG,23,DET,76,75,2529,370,928,.399,153,437,.350,217,491,.442,.481,154,185,.832,55,193,248,193,89,12,86,118,1047
67,Elfrid Payton\paytoel01,PG,22,ORL,82,58,2412,430,912,.471,40,146,.274,390,766,.509,.493,146,211,.692,89,298,387,529,88,40,178,177,1046
68,Dario Šarić\saricda01,PF,22,PHI,81,36,2129,381,927,.411,106,341,.311,275,586,.469,.468,172,220,.782,112,401,513,182,57,30,183,162,1040
69,Enes Kanter\kanteen01,C,24,OKC,72,0,1533,402,737,.545,5,38,.132,397,699,.568,.549,224,285,.786,195,287,482,67,32,38,123,154,1033
70,Jrue Holiday\holidjr01,PG,26,NOP,67,61,2190,405,893,.454,100,281,.356,305,612,.498,.510,119,168,.708,46,218,264,488,100,44,194,133,1029
71,DeAndre Jordan\jordade01,C,28,LAC,81,81,2570,412,577,.714,0,2,.000,412,575,.717,.714,205,425,.482,298,816,1114,96,51,134,115,212,1029
72,Zach Randolph\randoza01,PF,35,MEM,73,5,1786,433,964,.449,21,94,.223,412,870,.474,.460,141,193,.731,182,416,598,122,38,10,99,136,1028
73,Jabari Parker\parkeja01,PF,21,MIL,51,50,1728,399,814,.490,65,178,.365,334,636,.525,.530,162,218,.743,79,235,314,142,50,22,93,111,1025
74,Aaron Gordon\gordoaa01,SF,21,ORL,80,72,2298,393,865,.454,77,267,.288,316,598,.528,.499,156,217,.719,116,289,405,150,65,40,89,172,1019
75,Jamal Crawford\crawfja01,SG,36,LAC,82,1,2157,359,870,.413,116,322,.360,243,548,.443,.479,174,203,.857,17,112,129,214,61,14,134,115,1008
76,Dwight Howard\howardw01,C,31,ATL,74,74,2199,388,613,.633,0,2,.000,388,611,.635,.633,226,424,.533,296,644,940,104,64,92,170,203,1002
77,Tyler Johnson\johnsty01,PG,24,MIA,73,0,2178,357,824,.433,93,250,.372,264,574,.460,.490,195,254,.768,50,243,293,233,84,44,90,176,1002
78,Jae Crowder\crowdja01,SF,26,BOS,72,72,2335,333,720,.463,157,394,.398,176,326,.540,.572,176,217,.811,48,367,415,155,73,23,80,161,999
79,Wesley Matthews\matthwe02,SG,30,DAL,73,73,2495,333,847,.393,174,479,.363,159,368,.432,.496,146,179,.816,18,241,259,210,77,15,102,161,986
80,D'Angelo Russell\russeda01,PG,20,LAL,63,60,1811,351,867,.405,135,384,.352,216,483,.447,.483,147,188,.782,31,190,221,303,87,16,176,130,984
81,Ryan Anderson\anderry01,PF,28,HOU,72,72,2116,323,773,.418,204,506,.403,119,267,.446,.550,129,150,.860,112,218,330,68,31,14,55,142,979
82,James Johnson\johnsja01,PF,29,MIA,76,5,2085,368,769,.479,87,256,.340,281,513,.548,.535,152,215,.707,66,310,376,276,76,86,171,197,975
83,Julius Randle\randlju01,PF,22,LAL,74,73,2132,377,773,.488,17,63,.270,360,710,.507,.499,204,282,.723,150,486,636,264,49,37,173,248,975
84,Jonas Valančiūnas\valanjo01,C,24,TOR,80,80,2066,391,702,.557,1,2,.500,390,700,.557,.558,176,217,.811,226,533,759,57,37,63,106,216,959
85,Al Horford\horfoal01,C,30,BOS,68,68,2193,379,801,.473,86,242,.355,293,559,.524,.527,108,135,.800,95,370,465,337,52,86,115,138,952
86,Greg Monroe\monrogr01,C,26,MIL,81,0,1823,387,726,.533,0,4,.000,387,722,.536,.533,177,239,.741,167,365,532,187,92,38,140,168,951
87,T.J. Warren\warretj01,SF,23,PHO,66,59,2048,403,814,.495,26,98,.265,377,716,.527,.511,119,154,.773,125,214,339,75,76,39,57,175,951
88,Trevor Ariza\arizatr01,SF,31,HOU,80,80,2773,326,798,.409,191,555,.344,135,243,.556,.528,93,126,.738,54,404,458,175,147,20,73,133,936
89,Sean Kilpatrick\kilpase01,SG,27,BRK,70,24,1754,305,735,.415,105,308,.341,200,427,.468,.486,204,242,.843,22,258,280,157,45,6,135,118,919
90,Steven Adams\adamsst01,C,23,OKC,80,80,2389,374,655,.571,0,1,.000,374,654,.572,.571,157,257,.611,281,332,613,86,89,78,146,195,905
91,Darren Collison\collida01,PG,29,SAC,68,64,2063,340,714,.476,73,175,.417,267,539,.495,.527,147,171,.860,23,129,152,312,67,9,114,119,900
92,Seth Curry\curryse01,PG,26,DAL,70,42,2029,338,703,.481,137,322,.425,201,381,.528,.578,85,100,.850,25,154,179,189,79,7,92,126,898
93,Avery Bradley\bradlav01,SG,26,BOS,55,55,1835,359,775,.463,108,277,.390,251,498,.504,.533,68,93,.731,65,269,334,122,68,11,88,141,894
94,Zach LaVine\lavinza01,SG,21,MIN,47,47,1749,326,710,.459,120,310,.387,206,400,.515,.544,117,140,.836,19,141,160,139,41,10,85,104,889
95,Austin Rivers\riverau01,SG,24,LAC,74,29,2054,323,731,.442,111,299,.371,212,432,.491,.518,132,191,.691,20,141,161,204,48,10,115,187,889
96,Marcin Gortat\gortama01,C,32,WAS,82,82,2556,390,674,.579,0,2,.000,390,672,.580,.579,103,159,.648,238,611,849,121,40,61,119,213,883
97,Frank Kaminsky\kaminfr01,C,23,CHO,75,16,1954,320,802,.399,116,354,.328,204,448,.455,.471,118,156,.756,57,279,336,162,46,34,76,139,874
98,Buddy Hield\hieldbu01,SG,24,TOT,82,55,1888,327,767,.426,148,379,.391,179,388,.461,.523,64,76,.842,35,234,269,121,38,9,101,115,866
99,Robert Covington\covinro01,SF,26,PHI,67,67,2119,292,732,.399,137,412,.333,155,320,.484,.492,143,174,.822,92,344,436,102,127,69,131,203,864
100,Terrence Ross\rosste01,SF,25,TOT,78,24,1955,326,746,.437,142,391,.363,184,355,.518,.532,64,77,.831,18,188,206,88,87,33,68,143,858
101,Gary Harris\harriga01,SG,22,DEN,57,56,1782,320,637,.502,107,255,.420,213,382,.558,.586,104,134,.776,48,130,178,164,71,8,76,92,851
102,Marvin Williams\willima02,PF,30,CHO,76,76,2295,297,704,.422,124,354,.350,173,350,.494,.510,131,150,.873,89,411,500,106,58,53,60,134,849
103,Taj Gibson\gibsota01,PF,31,TOT,78,71,1989,365,709,.515,3,13,.231,362,696,.520,.517,113,158,.715,158,327,485,73,41,65,105,163,846
104,Allen Crabbe\crabbal01,SG,24,POR,79,7,2254,303,647,.468,134,302,.444,169,345,.490,.572,105,124,.847,19,207,226,94,54,20,62,171,845
105,Mason Plumlee\plumlma01,C,26,TOT,81,64,2148,334,623,.536,0,6,.000,334,617,.541,.536,174,300,.580,170,435,605,284,69,92,134,226,842
106,Robin Lopez\lopezro01,C,28,CHI,81,81,2271,382,775,.493,0,2,.000,382,773,.494,.493,75,104,.721,244,276,520,80,18,117,91,151,839
107,Ricky Rubio\rubiori01,PG,26,MIN,75,75,2469,261,650,.402,60,196,.306,201,454,.443,.448,254,285,.891,68,237,305,682,128,10,195,202,836
108,Courtney Lee\leeco01,SG,31,NYK,77,74,2459,321,704,.456,108,269,.401,213,435,.490,.533,85,98,.867,53,206,259,179,81,24,69,141,835
109,Marcus Smart\smartma01,SG,22,BOS,79,24,2399,269,749,.359,94,332,.283,175,417,.420,.422,203,250,.812,78,227,305,364,125,34,159,192,835
110,George Hill\hillge01,PG,30,UTA,49,49,1544,289,606,.477,94,233,.403,195,373,.523,.554,157,196,.801,23,144,167,204,50,11,85,114,829
111,Will Barton\bartowi01,SG,26,DEN,60,19,1705,295,666,.443,87,235,.370,208,431,.483,.508,143,190,.753,58,201,259,206,48,28,97,110,820
112,Clint Capela\capelca01,C,22,HOU,65,59,1551,362,563,.643,0,0,,362,563,.643,.643,94,177,.531,178,348,526,63,34,79,87,179,818
113,Gorgui Dieng\dienggo01,PF,27,MIN,82,82,2653,332,661,.502,16,43,.372,316,618,.511,.514,136,167,.814,188,459,647,158,88,95,107,254,816
114,C.J. Miles\milescj01,SF,29,IND,76,29,1776,281,647,.434,169,409,.413,112,238,.471,.565,84,93,.903,30,199,229,48,46,25,40,151,815
115,Thaddeus Young\youngth01,PF,28,IND,74,74,2237,362,687,.527,45,118,.381,317,569,.557,.560,45,86,.523,131,317,448,122,113,29,95,135,814
116,Jamal Murray\murraja01,SG,19,DEN,82,10,1764,295,730,.404,115,344,.334,180,386,.466,.483,106,120,.883,41,173,214,170,51,24,113,124,811
117,Kent Bazemore\bazemke01,SF,27,ATL,73,64,1963,295,721,.409,92,266,.346,203,455,.446,.473,119,168,.708,45,186,231,177,91,52,125,165,801
118,Pau Gasol\gasolpa01,C,36,SAS,64,39,1627,303,604,.502,56,104,.538,247,500,.494,.548,130,184,.707,107,394,501,150,24,70,81,110,792
119,Nick Young\youngni01,SG,31,LAL,60,60,1556,272,633,.430,170,421,.404,102,212,.481,.564,77,90,.856,25,113,138,58,37,14,36,137,791
120,Marco Belinelli\belinma01,SG,30,CHO,74,0,1778,264,615,.429,102,283,.360,162,332,.488,.512,150,168,.893,14,164,178,147,44,9,70,90,780
121,Draymond Green\greendr01,PF,26,GSW,76,76,2471,272,650,.418,81,263,.308,191,387,.494,.481,151,213,.709,98,501,599,533,154,106,184,217,776
122,Maurice Harkless\harklma01,SF,23,POR,77,69,2223,314,624,.503,68,194,.351,246,430,.572,.558,77,124,.621,125,216,341,88,85,70,86,214,773
123,Shabazz Muhammad\muhamsh01,SF,24,MIN,78,1,1516,288,598,.482,49,145,.338,239,453,.528,.523,147,190,.774,84,136,220,35,22,6,56,86,772
124,Dirk Nowitzki\nowitdi01,PF,38,DAL,54,54,1424,296,678,.437,79,209,.378,217,469,.463,.495,98,112,.875,23,330,353,82,30,38,51,113,769
125,Malcolm Brogdon\brogdma01,SG,24,MIL,75,28,1982,290,635,.457,78,193,.404,212,442,.480,.518,109,126,.865,47,166,213,317,84,12,113,140,767
126,Jon Leuer\leuerjo01,PF,27,DET,75,34,1944,310,646,.480,49,167,.293,261,479,.545,.518,98,113,.867,102,300,402,111,31,26,66,145,767
127,Patty Mills\millspa02,PG,28,SAS,80,8,1754,273,621,.440,147,355,.414,126,266,.474,.558,66,80,.825,24,117,141,280,65,3,101,109,759
128,Ish Smith\smithis01,PG,28,DET,81,32,1955,329,749,.439,28,105,.267,301,644,.467,.458,72,102,.706,21,214,235,418,61,33,112,127,758
129,Nik Stauskas\stausni01,SG,23,PHI,80,27,2188,251,634,.396,132,359,.368,119,275,.433,.500,122,150,.813,21,205,226,188,45,32,128,144,756
130,Marquese Chriss\chrisma01,PF,19,PHO,82,75,1743,284,632,.449,72,224,.321,212,408,.520,.506,113,181,.624,96,252,348,60,67,70,108,263,753
131,Reggie Jackson\jacksre01,PG,26,DET,52,50,1424,284,677,.419,66,184,.359,218,493,.442,.468,118,136,.868,21,93,114,270,35,5,114,129,752
132,Rodney Hood\hoodro01,SG,24,UTA,59,55,1593,272,666,.408,114,307,.371,158,359,.440,.494,90,115,.783,16,186,202,96,38,11,65,132,748
133,Nikola Mirotić\mirotni01,PF,25,CHI,70,15,1679,258,625,.413,129,377,.342,129,248,.520,.516,99,128,.773,61,323,384,75,53,55,80,128,744
134,Michael Kidd-Gilchrist\kiddgmi01,SF,23,CHO,81,81,2349,295,618,.477,1,9,.111,294,609,.483,.478,152,194,.784,156,409,565,114,81,77,56,187,743
135,Brandon Ingram\ingrabr01,SF,19,LAL,79,40,2279,276,686,.402,55,187,.294,221,499,.443,.442,133,214,.621,60,256,316,166,50,36,116,158,740
136,Cory Joseph\josepco01,PG,25,TOR,80,22,2003,299,661,.452,48,135,.356,251,526,.477,.489,94,122,.770,51,184,235,265,66,13,108,140,740
137,Dion Waiters\waitedi01,SG,25,MIA,46,43,1384,281,663,.424,85,215,.395,196,448,.438,.488,82,127,.646,18,135,153,200,42,20,103,95,729
138,Joe Johnson\johnsjo02,SF,35,UTA,78,14,1843,273,626,.436,106,258,.411,167,368,.454,.521,63,77,.818,33,210,243,144,36,18,69,93,715
139,Marreese Speights\speigma01,C,29,LAC,82,2,1286,244,548,.445,103,277,.372,141,271,.520,.539,120,137,.876,88,285,373,65,23,41,69,229,711
140,Trevor Booker\booketr01,PF,29,BRK,71,43,1754,305,591,.516,25,78,.321,280,513,.546,.537,74,110,.673,143,428,571,138,75,28,127,152,709
141,Deron Williams\willide01,PG,32,TOT,64,44,1657,263,600,.438,85,234,.363,178,366,.486,.509,90,109,.826,14,133,147,360,31,8,138,138,701
142,E'Twaun Moore\mooreet01,SG,27,NOP,73,22,1820,283,619,.457,77,208,.370,206,411,.501,.519,57,74,.770,33,119,152,164,50,32,62,131,700
143,JaMychal Green\greenja01,PF,26,MEM,77,75,2101,250,500,.500,55,145,.379,195,355,.549,.555,134,167,.802,167,377,544,84,47,34,94,248,689
144,Jameer Nelson\nelsoja01,PG,34,DEN,75,39,2045,268,604,.444,106,273,.388,162,331,.489,.531,45,63,.714,28,164,192,385,54,8,128,197,687
145,Tony Snell\snellto01,SG,25,MIL,80,80,2336,246,541,.455,144,355,.406,102,186,.548,.588,47,58,.810,22,226,248,96,55,14,55,125,683
146,Ty Lawson\lawsoty01,PG,29,SAC,69,24,1732,237,522,.454,34,118,.288,203,404,.502,.487,173,217,.797,44,135,179,334,74,6,129,119,681
147,Kyle Korver\korveky01,SG,35,TOT,67,22,1753,239,515,.464,162,359,.451,77,156,.494,.621,38,42,.905,7,179,186,110,34,21,69,107,678
148,Kelly Olynyk\olynyke01,C,25,BOS,75,6,1538,260,508,.512,68,192,.354,192,316,.608,.579,90,123,.732,73,288,361,148,43,29,96,207,678
149,Channing Frye\fryech01,C,33,CLE,74,15,1398,238,520,.458,137,335,.409,101,185,.546,.589,63,74,.851,37,253,290,45,33,37,53,138,676
150,Rondae Hollis-Jefferson\holliro01,SF,22,BRK,78,50,1761,235,542,.434,15,67,.224,220,475,.463,.447,190,253,.751,96,356,452,154,82,44,116,177,675
151,Gerald Henderson\hendege02,SG,29,PHI,72,41,1667,234,553,.423,61,173,.353,173,380,.455,.478,133,165,.806,34,151,185,112,40,15,62,129,662
152,Jusuf Nurkić\nurkiju01,C,22,TOT,65,48,1391,271,534,.507,0,1,.000,271,533,.508,.507,120,210,.571,154,313,467,123,50,74,143,161,662
153,Wayne Ellington\ellinwa01,SG,29,MIA,62,13,1500,231,555,.416,149,394,.378,82,161,.509,.550,37,43,.860,18,114,132,70,35,4,30,70,648
154,Tony Allen\allento01,SG,35,MEM,71,66,1914,274,595,.461,15,54,.278,259,541,.479,.473,80,130,.615,166,225,391,98,115,29,100,178,643
155,Patrick Beverley\beverpa01,SG,28,HOU,67,67,2058,228,543,.420,110,288,.382,118,255,.463,.521,73,95,.768,95,298,393,281,99,25,100,222,639
156,Cody Zeller\zelleco01,C,24,CHO,62,58,1725,253,443,.571,0,1,.000,253,442,.572,.571,133,196,.679,135,270,405,99,62,58,65,189,639
157,DeMarre Carroll\carrode01,SF,30,TOR,72,72,1882,220,550,.400,109,320,.341,111,230,.483,.499,89,117,.761,63,212,275,74,81,27,54,143,638
158,Jeff Green\greenje02,PF,30,ORL,69,11,1534,220,558,.394,53,193,.275,167,365,.458,.442,145,168,.863,39,175,214,81,37,13,75,103,638
159,Tony Parker\parketo01,PG,34,SAS,63,63,1587,265,569,.466,23,69,.333,242,500,.484,.486,85,117,.726,9,104,113,285,34,2,89,92,638
160,Norman Powell\powelno01,SG,23,TOR,76,18,1368,227,506,.449,56,173,.324,171,333,.514,.504,126,159,.792,26,143,169,82,52,14,70,127,636
161,Monta Ellis\ellismo01,SG,31,IND,74,33,1998,247,557,.443,43,135,.319,204,422,.483,.482,93,128,.727,19,185,204,236,78,27,135,149,630
162,Tristan Thompson\thomptr01,C,25,CLE,78,78,2336,262,437,.600,0,3,.000,262,434,.604,.600,106,213,.498,286,429,715,77,39,84,64,176,630
163,Justin Holiday\holidju01,SG,27,NYK,82,4,1639,233,538,.433,97,273,.355,136,265,.513,.523,66,80,.825,27,198,225,102,65,31,66,109,629
164,Joel Embiid\embiijo01,C,22,PHI,31,31,786,200,429,.466,36,98,.367,164,331,.495,.508,191,244,.783,61,182,243,66,27,76,117,112,627
165,D.J. Augustin\augusdj01,PG,29,ORL,78,20,1538,195,517,.377,95,274,.347,100,243,.412,.469,131,161,.814,15,102,117,209,31,1,90,101,616
166,Alex Len\lenal01,C,23,PHO,77,34,1560,230,463,.497,3,12,.250,227,451,.503,.500,150,208,.721,156,354,510,44,38,98,102,242,613
167,Willie Cauley-Stein\caulewi01,C,23,SAC,75,21,1421,255,481,.530,0,2,.000,255,479,.532,.530,101,151,.669,85,254,339,80,53,44,69,147,611
168,Nenê Hilário\hilarne01,C,34,HOU,67,8,1198,245,397,.617,3,9,.333,242,388,.624,.621,116,197,.589,95,187,282,65,56,39,73,163,609
169,Jeremy Lamb\lambje01,SG,24,CHO,62,5,1143,226,491,.460,41,146,.281,185,345,.536,.502,110,129,.853,30,234,264,75,27,23,40,98,603
170,Emmanuel Mudiay\mudiaem01,PG,20,DEN,55,41,1406,208,551,.377,56,178,.315,152,373,.408,.428,131,167,.784,29,149,178,217,41,13,123,95,603
171,Brandon Knight\knighbr03,SG,25,PHO,54,5,1140,209,525,.398,45,139,.324,164,386,.425,.441,132,154,.857,25,93,118,130,27,5,88,87,595
172,Doug McDermott\mcderdo01,SF,25,TOT,66,5,1508,222,497,.447,77,208,.370,145,289,.502,.524,71,84,.845,20,159,179,58,13,5,38,79,592
173,Jahlil Okafor\okafoja01,C,21,PHI,50,33,1134,242,471,.514,0,0,,242,471,.514,.514,106,158,.671,81,159,240,58,20,49,91,122,590
174,Kenneth Faried\farieke01,PF,27,DEN,61,34,1296,228,416,.548,0,6,.000,228,410,.556,.548,131,189,.693,183,279,462,55,43,40,59,124,587
175,Willy Hernangómez\hernawi01,C,22,NYK,72,22,1324,246,465,.529,4,15,.267,242,450,.538,.533,91,125,.728,170,332,502,96,41,36,100,150,587
176,Vince Carter\cartevi01,SF,40,MEM,73,15,1799,193,490,.394,112,296,.378,81,194,.418,.508,88,115,.765,36,191,227,133,60,36,50,163,586
177,Evan Turner\turneev01,SF,28,POR,65,12,1658,235,552,.426,31,118,.263,204,434,.470,.454,85,103,.825,36,211,247,205,53,24,100,121,586
178,Langston Galloway\gallola01,PG,25,TOT,74,2,1495,207,545,.380,120,308,.390,87,237,.367,.490,51,64,.797,27,129,156,93,46,6,46,96,585
179,Terrence Jones\joneste01,PF,25,TOT,54,12,1270,231,492,.470,19,75,.253,212,417,.508,.489,103,170,.606,65,241,306,59,40,54,48,67,584
180,Joe Ingles\inglejo01,SF,29,UTA,82,26,1972,204,451,.452,123,279,.441,81,172,.471,.589,50,68,.735,23,238,261,225,96,8,107,163,581
181,Matthew Dellavedova\dellama01,PG,26,MIL,76,54,1986,208,534,.390,79,215,.367,129,319,.404,.463,82,96,.854,24,123,147,357,53,0,133,153,577
182,Brandon Jennings\jennibr01,PG,27,TOT,81,13,1802,192,535,.359,79,252,.313,113,283,.399,.433,114,152,.750,29,167,196,395,70,4,128,116,577
183,David Lee\leeda02,PF,33,SAS,79,10,1477,248,420,.590,0,0,,248,420,.590,.590,80,113,.708,149,292,441,124,31,40,82,125,576
184,Andre Iguodala\iguodan01,SF,33,GSW,76,0,1998,219,415,.528,64,177,.362,155,238,.651,.605,72,102,.706,51,253,304,261,76,39,58,97,574
185,Iman Shumpert\shumpim01,SG,26,CLE,76,31,1937,201,489,.411,94,261,.360,107,228,.469,.507,71,90,.789,39,179,218,109,62,27,78,150,567
186,Solomon Hill\hillso01,SF,25,NOP,80,71,2374,183,478,.383,94,270,.348,89,208,.428,.481,103,128,.805,51,256,307,141,72,32,82,182,563
187,Rudy Gay\gayru01,SF,30,SAC,30,30,1013,201,442,.455,42,113,.372,159,329,.483,.502,118,138,.855,35,155,190,83,44,26,74,79,562
188,Richaun Holmes\holmeri01,C,23,PHI,57,17,1193,230,412,.558,27,77,.351,203,335,.606,.591,72,103,.699,94,217,311,58,42,55,55,136,559
189,T.J. McConnell\mccontj01,PG,24,PHI,81,51,2133,236,512,.461,11,55,.200,225,457,.492,.472,73,90,.811,39,212,251,534,134,10,159,139,556
190,Troy Daniels\danietr01,SG,25,MEM,67,3,1183,185,495,.374,138,355,.389,47,140,.336,.513,43,54,.796,22,78,100,46,20,4,45,90,551
191,Isaiah Whitehead\whiteis01,PG,21,BRK,73,26,1643,204,508,.402,44,149,.295,160,359,.446,.445,91,113,.805,32,152,184,192,42,36,142,175,543
192,P.J. Tucker\tuckepj01,SF,31,TOT,81,21,2236,199,482,.413,70,196,.357,129,286,.451,.485,72,93,.774,117,354,471,99,116,19,66,196,540
193,Josh Richardson\richajo01,SG,23,MIA,53,34,1614,202,513,.394,75,227,.330,127,286,.444,.467,60,77,.779,35,133,168,140,60,39,65,132,539
194,Raymond Felton\feltora01,PG,32,LAC,80,11,1700,221,514,.430,46,144,.319,175,370,.473,.475,50,64,.781,33,185,218,191,66,22,83,125,538
195,Rajon Rondo\rondora01,PG,30,CHI,69,42,1843,229,561,.408,50,133,.376,179,428,.418,.453,30,50,.600,73,282,355,461,99,11,169,144,538
196,Al Jefferson\jeffeal01,C,32,IND,66,1,931,235,471,.499,0,1,.000,235,470,.500,.499,65,85,.765,75,203,278,57,19,16,33,125,535
197,Al-Farouq Aminu\aminual01,PF,26,POR,61,25,1773,183,466,.393,70,212,.330,113,254,.445,.468,96,136,.706,77,374,451,99,60,44,94,102,532
198,Justin Anderson\anderju01,SF,23,TOT,75,10,1228,186,439,.424,58,194,.299,128,245,.522,.490,102,129,.791,69,176,245,66,41,23,66,109,532
199,Sergio Rodríguez\rodrise01,PG,30,PHI,68,30,1518,210,536,.392,92,252,.365,118,284,.415,.478,18,27,.667,21,136,157,344,49,4,128,95,530
200,Michael Beasley\beaslmi01,PF,28,MIL,56,6,935,216,406,.532,18,43,.419,198,363,.545,.554,78,105,.743,40,153,193,53,27,27,66,92,528
201,Matt Barnes\barnema02,SF,36,TOT,74,18,1777,185,473,.391,87,263,.331,98,210,.467,.483,70,89,.787,70,314,384,195,48,26,107,185,527
202,Ian Clark\clarkia01,SG,25,GSW,77,0,1137,211,433,.487,61,163,.374,150,270,.556,.558,44,58,.759,22,99,121,90,39,8,55,77,527
203,Montrezl Harrell\harremo01,C,23,HOU,58,14,1064,225,345,.652,1,7,.143,224,338,.663,.654,76,121,.628,81,138,219,64,20,42,44,126,527
204,Jeremy Lin\linje01,PG,28,BRK,36,33,883,175,400,.438,58,156,.372,117,244,.480,.510,115,141,.816,11,124,135,184,42,14,86,79,523
205,Andre Roberson\roberan03,SF,25,OKC,79,79,2376,215,463,.464,45,184,.245,170,279,.609,.513,47,111,.423,98,305,403,79,94,79,51,204,522
206,Amir Johnson\johnsam01,PF,29,BOS,80,77,1608,213,370,.576,27,66,.409,186,304,.612,.612,67,100,.670,118,248,366,140,51,62,77,211,520
207,Manu Ginóbili\ginobma01,SG,39,SAS,69,0,1291,171,439,.390,89,227,.392,82,212,.387,.491,86,107,.804,28,129,157,183,82,16,96,119,517
208,Dwight Powell\poweldw01,C,25,DAL,77,3,1333,194,377,.515,21,74,.284,173,303,.571,.542,107,141,.759,93,213,306,49,61,39,34,135,516
209,Arron Afflalo\afflaar01,SG,31,SAC,61,45,1580,185,420,.440,62,151,.411,123,269,.457,.514,83,93,.892,9,116,125,78,21,6,42,104,515
210,Jaylen Brown\brownja02,SF,20,BOS,78,20,1341,192,423,.454,46,135,.341,146,288,.507,.508,85,124,.685,45,175,220,64,35,18,68,142,515
211,Garrett Temple\templga01,SG,30,SAC,65,21,1728,183,432,.424,82,220,.373,101,212,.476,.519,58,74,.784,32,152,184,168,84,28,78,141,506
212,Sam Dekker\dekkesa01,PF,22,HOU,77,2,1419,203,429,.473,60,187,.321,143,242,.591,.543,38,68,.559,94,190,284,76,38,21,41,83,504
213,Kelly Oubre\oubreke01,SF,21,WAS,79,5,1605,186,442,.421,54,188,.287,132,254,.520,.482,75,99,.758,61,200,261,47,58,17,50,195,501
214,Danny Green\greenda02,SG,29,SAS,68,68,1807,176,449,.392,118,311,.379,58,138,.420,.523,27,32,.844,31,193,224,124,70,57,76,120,497
215,Rodney McGruder\mcgruro01,SG,25,MIA,78,65,1966,190,460,.413,73,220,.332,117,240,.488,.492,44,71,.620,94,162,256,124,46,18,56,140,497
216,Kyle O'Quinn\oquinky01,C,26,NYK,79,8,1229,215,413,.521,2,17,.118,213,396,.538,.523,64,83,.771,157,282,439,117,36,104,76,174,496
217,Ben McLemore\mclembe01,SG,23,SAC,61,26,1176,180,419,.430,65,170,.382,115,249,.462,.507,70,93,.753,19,110,129,51,29,6,62,108,495
218,Luc Mbah a Moute\mbahalu01,SF,30,LAC,80,76,1787,191,378,.505,43,110,.391,148,268,.552,.562,59,87,.678,44,126,170,39,81,35,46,122,484
219,Bismack Biyombo\biyombi01,C,24,ORL,81,27,1793,179,339,.528,0,0,,179,339,.528,.528,125,234,.534,157,410,567,74,25,91,95,202,483
220,Jonathon Simmons\simmojo02,SG,27,SAS,78,8,1392,177,421,.420,30,102,.294,147,319,.461,.456,99,132,.750,20,140,160,126,47,25,76,146,483
221,Domantas Sabonis\sabondo01,PF,20,OKC,81,66,1632,192,481,.399,51,159,.321,141,322,.438,.452,44,67,.657,46,242,288,82,39,32,83,200,479
222,Derrick Favors\favorde01,PF,25,UTA,50,39,1186,203,417,.487,3,10,.300,200,407,.491,.490,67,109,.615,92,213,305,56,45,40,60,103,476
223,JaVale McGee\mcgeeja01,C,29,GSW,77,10,739,208,319,.652,0,3,.000,208,316,.658,.652,56,111,.505,100,144,244,17,19,67,40,109,472
224,Kosta Koufos\koufoko01,C,27,SAC,71,62,1419,216,392,.551,0,1,.000,216,391,.552,.551,38,62,.613,118,285,403,47,36,48,61,172,470
225,Caris LeVert\leverca01,SF,22,BRK,57,26,1237,171,380,.450,59,184,.321,112,196,.571,.528,67,93,.720,23,165,188,110,49,8,59,91,468
226,Tim Frazier\fraziti01,PG,26,NOP,65,35,1525,163,404,.403,40,128,.313,123,276,.446,.453,98,129,.760,34,139,173,335,56,6,101,133,464
227,Yogi Ferrell\ferreyo01,PG,23,TOT,46,29,1197,160,394,.406,68,176,.386,92,218,.422,.492,74,89,.831,20,91,111,172,42,9,70,90,462
228,Anthony Tolliver\tollian01,PF,31,SAC,65,9,1477,155,351,.442,90,230,.391,65,121,.537,.570,61,82,.744,51,186,237,77,34,20,56,109,461
229,Mirza Teletović\teletmi01,PF,31,MIL,70,2,1133,156,418,.373,104,305,.341,52,113,.460,.498,35,45,.778,11,151,162,48,12,13,37,109,451
230,Larry Nance\nancela02,PF,24,LAL,63,7,1442,190,361,.526,10,36,.278,180,325,.554,.540,59,80,.738,120,249,369,96,82,39,56,149,449
231,Richard Jefferson\jefferi01,SF,36,CLE,79,13,1614,153,343,.446,62,186,.333,91,157,.580,.536,80,108,.741,28,175,203,78,26,10,52,153,448
232,Timothé Luwawu-Cabarrot\luwawti01,SF,21,PHI,69,19,1190,145,361,.402,50,161,.311,95,200,.475,.471,105,123,.854,25,124,149,75,32,10,73,154,445
233,Nerlens Noel\noelne01,C,22,TOT,51,19,1047,184,309,.595,0,1,.000,184,308,.597,.595,77,111,.694,93,201,294,50,65,50,51,126,445
234,Patrick Patterson\pattepa01,PF,27,TOR,65,8,1599,154,384,.401,94,253,.372,60,131,.458,.523,43,60,.717,62,231,293,76,40,23,38,120,445
235,Thabo Sefolosha\sefolth01,SF,32,ATL,62,42,1596,174,395,.441,41,120,.342,133,275,.484,.492,55,75,.733,54,216,270,107,96,31,58,97,444
236,Tyler Ulis\ulisty01,PG,21,PHO,61,15,1123,184,437,.421,21,79,.266,163,358,.455,.445,55,71,.775,20,75,95,226,48,5,77,73,444
237,Justin Hamilton\hamilju01,C,26,BRK,64,7,1177,174,379,.459,55,180,.306,119,199,.598,.532,39,52,.750,71,191,262,55,29,43,43,91,442
238,Trey Lyles\lylestr01,PF,21,UTA,71,4,1158,159,439,.362,65,204,.319,94,235,.400,.436,57,79,.722,48,187,235,69,26,20,64,97,440
239,Jerami Grant\grantje01,PF,22,TOT,80,4,1531,152,328,.463,43,116,.371,109,212,.514,.529,90,147,.612,38,167,205,46,33,79,44,149,437
240,Devin Harris\harride01,PG,33,DAL,65,0,1087,136,341,.399,58,177,.328,78,164,.476,.484,107,129,.829,11,116,127,136,43,7,57,101,437
241,Bobby Portis\portibo01,PF,21,CHI,64,13,1000,183,375,.488,32,96,.333,151,279,.541,.531,39,59,.661,75,221,296,35,16,11,37,94,437
242,Dante Cunningham\cunnida01,PF,29,NOP,66,35,1649,174,359,.485,71,181,.392,103,178,.579,.584,16,27,.593,56,221,277,37,39,28,28,100,435
243,Mike Muscala\muscami01,C,25,ATL,70,3,1237,170,337,.504,46,110,.418,124,227,.546,.573,49,64,.766,76,164,240,95,30,41,55,97,435
244,Jared Dudley\dudleja01,PF,31,PHO,64,7,1362,157,346,.454,77,203,.379,80,143,.559,.565,43,65,.662,31,194,225,121,42,16,73,154,434
245,Spencer Dinwiddie\dinwisp01,PG,23,BRK,59,18,1334,134,302,.444,38,101,.376,96,201,.478,.507,126,159,.792,27,137,164,185,44,23,66,119,432
246,Shelvin Mack\macksh01,PG,26,UTA,55,9,1205,170,381,.446,37,120,.308,133,261,.510,.495,53,77,.688,20,105,125,154,42,3,90,100,430
247,James Ennis\ennisja01,SF,26,MEM,64,28,1501,146,321,.455,51,137,.372,95,184,.516,.534,86,110,.782,69,190,259,64,46,19,59,165,429
248,Joe Harris\harrijo01,SG,25,BRK,52,11,1138,154,362,.425,85,221,.385,69,141,.489,.543,35,49,.714,16,131,147,54,30,8,55,121,428
249,Khris Middleton\middlkh01,SF,25,MIL,29,23,889,150,333,.450,45,104,.433,105,229,.459,.518,81,92,.880,11,112,123,99,41,7,65,79,426
250,Zaza Pachulia\pachuza01,C,32,GSW,70,70,1268,164,307,.534,0,2,.000,164,305,.538,.534,98,126,.778,140,270,410,132,59,33,87,166,426
251,Luol Deng\denglu01,SF,31,LAL,56,49,1486,164,424,.387,51,165,.309,113,259,.436,.447,46,63,.730,63,232,295,74,48,20,43,61,425
252,Andrew Harrison\harrian01,PG,22,MEM,72,18,1474,117,360,.325,43,156,.276,74,204,.363,.385,148,194,.763,23,113,136,198,53,21,85,194,425
253,Mindaugas Kuzminskas\kuzmimi01,SF,27,NYK,68,5,1016,158,369,.428,54,168,.321,104,201,.517,.501,55,68,.809,47,79,126,69,29,11,51,79,425
254,Jason Smith\smithja02,C,30,WAS,74,3,1068,174,329,.529,37,78,.474,137,251,.546,.585,35,51,.686,64,194,258,37,21,54,58,168,420
255,Leandro Barbosa\barbole01,SG,34,PHO,67,0,963,172,392,.439,35,98,.357,137,294,.466,.483,40,45,.889,15,89,104,81,31,8,48,82,419
256,Glenn Robinson\robingl02,SF,23,IND,69,27,1427,158,338,.467,49,125,.392,109,213,.512,.540,54,76,.711,57,189,246,47,41,20,37,63,419
257,Dante Exum\exumda01,PG,21,UTA,66,26,1228,155,363,.427,44,149,.295,111,214,.519,.488,58,73,.795,30,102,132,111,21,12,80,146,412
258,Tyreke Evans\evansty01,SF,27,TOT,40,6,788,150,370,.405,42,118,.356,108,252,.429,.462,69,92,.750,13,124,137,124,35,9,61,60,411
259,Terry Rozier\roziete01,PG,22,BOS,74,0,1263,151,411,.367,57,179,.318,94,232,.405,.437,51,66,.773,40,187,227,131,46,11,47,69,410
260,Álex Abrines\abrinal01,SG,23,OKC,68,6,1055,134,341,.393,94,247,.381,40,94,.426,.531,44,49,.898,18,68,86,40,37,8,33,114,406
261,Nemanja Bjelica\bjeline01,PF,28,MIN,65,1,1190,151,356,.424,56,177,.316,95,179,.531,.503,45,61,.738,57,187,244,79,40,20,59,154,403
262,Meyers Leonard\leoname01,PF,24,POR,74,12,1222,146,378,.386,74,213,.347,72,165,.436,.484,35,40,.875,27,210,237,71,13,28,35,172,401
263,Timofey Mozgov\mozgoti01,C,30,LAL,54,52,1104,169,328,.515,0,1,.000,169,327,.517,.515,63,78,.808,104,160,264,43,16,31,72,133,401
264,Tyson Chandler\chandty01,C,34,PHO,47,46,1298,153,228,.671,0,0,,153,228,.671,.671,91,124,.734,153,386,539,30,33,24,65,126,397
265,John Henson\hensojo01,C,26,MIL,58,39,1123,159,309,.515,0,1,.000,159,308,.516,.515,74,107,.692,92,203,295,57,29,78,52,151,392
266,Malcolm Delaney\delanma01,PG,27,ATL,73,2,1248,145,388,.374,26,110,.236,119,278,.428,.407,75,93,.806,10,113,123,193,39,1,95,112,391
267,Shaun Livingston\livinsh01,PG,31,GSW,76,3,1345,173,316,.547,1,3,.333,172,313,.550,.549,42,60,.700,28,123,151,139,38,20,62,120,389
268,Dewayne Dedmon\dedmode01,C,27,SAS,76,37,1330,161,259,.622,0,0,,161,259,.622,.622,65,93,.699,129,367,496,44,37,61,61,180,387
269,Tarik Black\blackta01,C,25,LAL,67,16,1091,150,294,.510,1,2,.500,149,292,.510,.512,82,109,.752,144,199,343,39,29,44,58,173,383
270,J.J. Barea\bareajo01,PG,32,DAL,35,6,771,142,343,.414,53,148,.358,89,195,.456,.491,44,51,.863,9,75,84,193,14,1,63,30,381
271,Joffrey Lauvergne\lauvejo01,PF-C,25,TOT,70,1,980,148,336,.440,33,98,.337,115,238,.483,.490,46,73,.630,72,179,251,70,25,6,56,83,375
272,Willie Reed\reedwi02,C,26,MIA,71,5,1031,162,285,.568,1,4,.250,161,281,.573,.570,49,88,.557,129,203,332,26,18,47,31,137,374
273,Corey Brewer\breweco01,SF,30,TOT,82,11,1281,147,348,.422,27,118,.229,120,230,.522,.461,50,68,.735,32,134,166,97,61,20,55,133,371
274,Jerian Grant\grantje02,PG,24,CHI,63,28,1028,128,301,.425,49,134,.366,79,167,.473,.507,65,73,.890,17,94,111,121,47,8,44,93,370
275,Aron Baynes\baynear01,C,30,DET,75,2,1163,143,279,.513,0,0,,143,279,.513,.513,79,94,.840,111,222,333,32,17,39,50,166,365
276,Randy Foye\foyera01,SG,33,BRK,69,40,1284,118,325,.363,67,203,.330,51,122,.418,.466,54,63,.857,9,146,155,135,35,9,80,99,357
277,J.R. Smith\smithjr01,SG,31,CLE,41,35,1187,123,356,.346,95,271,.351,28,85,.329,.479,10,15,.667,17,96,113,62,40,11,26,77,351
278,Dorian Finney-Smith\finnedo01,PF,23,DAL,81,35,1642,124,333,.372,56,191,.293,68,142,.479,.456,46,61,.754,55,167,222,67,52,25,45,125,350
279,Alan Williams\willial03,C,24,PHO,47,0,708,138,267,.517,0,1,.000,138,266,.519,.517,70,112,.625,94,198,292,23,27,32,37,125,346
280,Stanley Johnson\johnsst04,SF,20,DET,77,1,1371,129,365,.353,45,154,.292,84,211,.398,.415,36,53,.679,36,153,189,105,56,24,71,121,339
281,Boris Diaw\diawbo01,PF,34,UTA,73,33,1283,146,327,.446,20,81,.247,126,246,.512,.477,26,35,.743,46,112,158,170,18,9,87,83,338
282,Spencer Hawes\hawessp01,PF,28,TOT,54,1,797,134,277,.484,25,81,.309,109,196,.556,.529,44,52,.846,38,153,191,81,15,30,49,77,337
283,Taurean Waller-Prince\princta02,SF,22,ATL,59,10,981,114,285,.400,33,102,.324,81,183,.443,.458,74,94,.787,25,132,157,55,43,27,61,96,335
284,Jodie Meeks\meeksjo01,SG,29,ORL,36,10,738,103,256,.402,56,137,.409,47,119,.395,.512,65,74,.878,5,72,77,45,34,4,36,41,327
285,Noah Vonleh\vonleno01,PF,21,POR,74,41,1265,130,270,.481,7,20,.350,123,250,.492,.494,60,94,.638,131,256,387,31,30,27,64,154,327
286,Luke Babbitt\babbilu01,SF,27,MIA,68,55,1065,113,281,.402,87,210,.414,26,71,.366,.557,11,15,.733,12,129,141,36,20,11,25,118,324
287,Aaron Brooks\brookaa01,PG,32,IND,65,0,894,121,300,.403,48,128,.375,73,172,.424,.483,32,40,.800,18,51,69,125,25,9,66,93,322
288,Mario Hezonja\hezonma01,SF,21,ORL,65,2,960,117,330,.355,43,144,.299,74,186,.398,.420,40,50,.800,20,126,146,62,30,15,58,74,317
289,Cristiano Felício\feliccr01,C,24,CHI,66,0,1040,128,221,.579,0,0,,128,221,.579,.579,60,93,.645,124,187,311,40,25,17,33,110,316
290,David West\westda01,C,36,GSW,68,0,854,135,252,.536,3,8,.375,132,244,.541,.542,43,56,.768,47,156,203,151,42,48,78,105,316
291,Ramon Sessions\sessira01,PG,30,CHO,50,1,811,100,263,.380,21,62,.339,79,201,.393,.420,91,118,.771,11,62,73,129,27,3,46,43,312
292,Jason Terry\terryja01,SG,39,MIL,74,0,1365,105,243,.432,73,171,.427,32,72,.444,.582,24,29,.828,15,91,106,98,46,20,36,95,307
293,Juan Hernangómez\hernaju01,PF,21,DEN,62,9,842,101,224,.451,46,113,.407,55,111,.495,.554,57,76,.750,43,144,187,29,30,12,31,62,305
294,Derrick Williams\willide02,PF,25,TOT,50,11,804,108,244,.443,30,97,.309,78,147,.531,.504,58,89,.652,19,111,130,28,14,7,28,60,304
295,Dāvis Bertāns\bertada01,PF,24,SAS,67,6,808,103,234,.440,69,173,.399,34,61,.557,.588,28,34,.824,22,76,98,46,20,28,32,75,303
296,Jonas Jerebko\jerebjo01,PF,29,BOS,78,6,1232,114,262,.435,45,130,.346,69,132,.523,.521,26,37,.703,59,213,272,71,25,17,39,122,299
297,Michael Carter-Williams\cartemi01,PG,25,CHI,45,19,846,112,306,.366,15,64,.234,97,242,.401,.391,58,77,.753,24,129,153,113,38,23,66,102,297
298,Kris Dunn\dunnkr01,PG,22,MIN,78,7,1333,118,313,.377,21,73,.288,97,240,.404,.411,36,59,.610,24,142,166,188,78,36,89,178,293
299,Brandon Bass\bassbr01,PF,31,LAC,52,0,577,107,186,.575,1,3,.333,106,183,.579,.578,77,88,.875,43,86,129,21,14,11,29,45,292
300,Denzel Valentine\valende01,SG,23,CHI,57,0,976,102,288,.354,73,208,.351,29,80,.363,.481,14,18,.778,11,140,151,63,30,7,49,86,291
